20 20
###################
#.................#
#.#################
#.#...............#
#.#.#############.#
#.................#
######..........###
#......## ###.....#
#.#....#FFFF#.....#
#.#....######.....#
#.#.........#.....#
#.......###########
#........#........#
#0....#...#...#...#
#.#...#...#...#...#
#.#...#...#...#...#
#.......<.#...#...#
###################
