13 20
####################
#0...#........#...0#
#.##.#.##..##.#.##.#
#.#.....#..#.....#.#
#.#.##.##  ##.##.#.#
#......  0  #.#....#
#.#....######.#..#.#
#.#....#FFFF#.#..#.#
#.#....# ####.#..#.#
#.#...........#..#.#
#.##.#.######.#.##.#
#0...#...<....#...0#
####################
